5 7
#######
#     #
#c    #
#..   #
.###.##
8 10
##########
#        #
#        #
#   .#.  #
#   .#.  #
# c      #
#        #
####..####