10       15
###############
#     #       #
#     #       #
# *   ###     #
###     #     #
# #     #   # #
# #  ######## #
#       #     #
#  ###      # #
###############
