8 10
##########
#*       #
#        #
#   .#.  #
#   .#.  #
#        #
#        #
####..####
